####################
#__________________#
#____###___________#
#__________________#
#______________#___#
#__##______________#
#__##__________#___#
#__##______________#
#__________________#
#________#####_____#
#__________________#
#__________________#
#__________________#
#____##____________#
#__________________#
#_____________###__#
#_____________##___#
#__#__________#____#
#__#_______________#
####################