####################
#__________________#
#__________________#
#___####___________#
#__________________#
#__________________#
#_____________######
#__________________#
#__________________#
#__________________#
#__________________#
####_______________#
#__________________#
#__________________#
#__________________#
#______________#####
#__________________#
#__________________#
#__________________#
####################