####################
#__________________#
#____###_________###
#__________________#
#__________________#
#__##______________#
#__________________#
#__##______________#
#__________________#
#______#######_____#
#____________#_____#
#________##________#
#__________________#
#____##____________#
#_____________####_#
#_____________###__#
#_____________##___#
#_____________#____#
#__________________#
####################